Rank,Country,Gold,Silver,Bronze,Total
1,United States,40,44,42,126
2,China,40,27,24,91
7,Great Britain,14,22,29,65
5,France,16,26,22,64
4,Australia,18,19,16,53
3,Japan,20,12,13,45
9,Italy,12,13,15,40
6,Netherlands,15,7,12,34
10,Germany,12,13,8,33
8,South Korea,13,9,10,32
